1111111111111111111111111111111111
1000000000000000000000000000000001
1010010010101010001001000E00010101
1P00010000000000000000000000000001
1111111111111111111111111111111111
