1111111111111111111111111111111111
10000000000000C00000C000000000000
1010010010101010001001000E00010101
1P0001000C00C0000000000000000000C1
1111111111111111111111111111111111
